mataphysical	metaphysical
arival	arrival
emminent	imminent
substace	substance
ninteenth	nineteenth
collonade	colonnade
visting	visiting
dectect	detect
mroe	more
aquitted	acquitted
stregth	strength
ancestory	ancestry
nabumetone	nabumetone
responsibile	responsible
stanozolol	stanozolol
aquired	acquired
lyrics	lyrics
runing	running
approxamately	approximately
derango	derango
chemicaly	chemically
fungus	fungus
bloomingdales	bloomingdales
interbread	interbreed
decribed	described
spiroplasma	spiroplasma
lenght	length
hydrochlorothiazide	hydrochlorothiazide
tabc	tabc
adhearing	adhering
nucular	nuclear
zaxbys	zaxby s
intruduced	introduced
inheritage	inheritance
herbalife	herbalife
vriety	variety
pharoah	pharaoh
excellance	excellence
perade	parade
distiction	distinction
terriory	territory
candidiate	candidate
tile	tile
constanly	constantly
dnrec	dnrec
agaisnt	against
perenially	perennially
stuctured	structured
torpeados	torpedoes
ytou	you
seeked	sought
tweeze	tweeze
usmc	usmc
relatiopnship	relationship
knee	knee
dieing	dyeing
unforgetable	unforgettable
desintegrated	disintegrated
pepgen	pepgen
percocet	percocet
unitesstates	unitedstates
mackeral	mackerel
gracefull	graceful
cencus	census
consituency	constituency
stoneham	stoneham
sucessfuly	successfully
liasons	liaisons
avation	aviation
olies	ollie s
labled	labeled
voleyball	volleyball
preamble	preamble
headquater	headquarter
earthworm	earthworm
grotius	grotius
contined	continued
disctinctive	distinctive
incompatabilities	incompatibilities
seige	siege
recontructed	reconstructed
dieting	dieting
trafficed	trafficked
liesure	leisure
comminication	communication
annuled	annulled
wroet	wrote
inlcuding	including
1800flowers	1 800 flowers
maculatum	maculatum
liekd	liked
condidtions	conditions
comitting	committing
charaterized	characterized
addopt	adopt
shrinked	shrunk
dissapears	disappears
provisiosn	provision
presense	presence
calculs	calculus
snags	snags
countires	countries
gauranteed	guaranteed
running	running
embezelled	embezzled
irelevent	irrelevant
manisfestations	manifestations
writ	writ
signficant	significant
ptsd	ptsd
placebo	placebo
adelaide	adelaide
hasbro	hasbro
cathlic	catholic
accension	accession
portugese	portuguese
recomends	recommends
opthalmology	ophthalmology
intered	interred
literture	literature
atain	attain
availaible	available
ins	ins
glucofast	glucofast
succesive	successive
conscent	consent
lobbyist	lobbyist
agravate	aggravate
raelly	really
magincian	magician
silverstatekennelclub	silver state kennel club
sonata	sonata
riddex	riddex
tepmorarily	temporarily
heared	heard
repentent	repentant
temptinganime	tempting anime
isohunt	isohunt
ai	ai
manouvers	manoeuvres
adquiring	acquiring
immediatley	immediately
sumer	sumer
oposite	opposite
puchasing	purchasing
leran	learn
harrassed	harassed
siezure	seizure
scholarstic	scholastic
heiroglyphics	hieroglyphics
xeroderma	xeroderma
tvguard	tv guard
warrent	warrant
sinse	sines
isnt	isn t
lisence	licence
prominately	prominently
bbb	bbb
ocasioned	occasioned
kalanchoe	kalanchoe
aiport	airport
accomadate	accommodate
prespective	perspective
premillenial	premillennial
cmc	cmc
millitary	military
etrakit	etrakit
pregancies	pregnancies
snese	sneeze
efficent	efficient
vailidty	validity
tendancy	tendency
compatiblity	compatibility
incidentially	incidentally
habsbourg	habsburg
elsbeth	elsbeth
onot	note
awared	awarded
themselfs	themselves
tradingpost	trading post
excells	excels
conection	connection
rhymme	rhyme
includng	including
marisota	marisota
momento	memento
twistys	twistys
mkaes	makes
billclinton	bill clinton
inprisonment	imprisonment
whants	wants
mischievious	mischievous
attemts	attempts
assoicated	associated
certainity	certainty
rockefeller	rockefeller
emblamatic	emblematic
tvs	tvs
thn	then
baltimorecity	baltimore city
encephalitis	encephalitis
androgeny	androgyny
elphant	elephant
surronded	surrounded
improvments	improvements
incompatablity	incompatibility
recepient	recipient
comission	commission
statment	statement
eee	eee
simplier	simpler
threatning	threatening
dessicated	desiccated
monolite	monolithic
adn	and
93x	93x
desoriented	disoriented
preeclampsia	preeclampsia
mikesfamousharleydavidson	mikes famous harley davidson
optmizations	optimizations
petra	petra
surreptiously	surreptitiously
rockerfeller	rockefeller
profesion	profession
mounth	month
japanation	japanation
glaucoma	glaucoma
hobos	hobos
emiting	emitting
roentgenographic	roentgenographic
copmetitors	competitors
adavanced	advanced
revolutionar	revolutionary
alchohol	alcohol
spas	spas
coincedentally	coincidentally
algoritm	algorithm
monestaries	monasteries
assasinated	assassinated
edema	edema
consonent	consonant
stilus	stylus
enourmous	enormous
longo	longo
overshaddowed	overshadowed
comited	committed
rechargable	rechargeable
poverty	poverty
authrorities	authorities
abondons	abandons
melieux	milieux
definetly	definitely
launchs	launch
noticable	noticeable
metamorphysis	metamorphosis
responsability	responsibility
optimalisatie	optimalisatie
lieuenant	lieutenant
mammograms	mammograms
alientating	alienating
spectum	spectrum
enviromental	environmental
spain	spain
daisy	daisy
coorperation	corporation
begginers	beginners
tormenters	tormentors
mamal	mammal
returnd	returned
childbird	childbirth
guerrilas	guerrillas
emi	emi
devestating	devastating
embarq	embarq
orkut	orkut
mexico	mexico
grittv	grittv
synagouge	synagogue
ebettetlife	a better life
enviromentalist	environmentalist
ihaca	ithaca
pbreak	pbreak
pielonefritis	pielonefritis
diamons	diamonds
elwebbs	elwebbs
lazyness	laziness
zzounds	zzounds
aspe	aspe
hedging	hedging
beggin	begin
bape	bape
millenia	millennia
emmisarries	emissaries
philisophy	philosophy
harrison	harrison
decress	decrees
throrough	thorough
assualt	assault
livley	lively
diet	diet
jackieocaudill	jackie o caudill
futhermore	furthermore
ambient	ambient
surpress	suppress
refference	reference
ncsa	ncsa
vegtable	vegetable
knack	knack
gridles	griddles
busineses	businesses
skelaxin	skelaxin
casette	cassette
slingo	slingo
translaters	translators
franchise	franchise
interational	international
amoung	among
recipiant	recipient
widesread	widespread
philospher	philosopher
xx24xx	xx24xx
hinderence	hindrance
ceramabryte	cerama bryte
meats	meats
inmigrants	immigrants
caluclated	calculated
cronicheadaches	chronic headaches
myrka	myrka
crystalisation	crystallisation
surveyer	surveyor
beleives	believes
menorraghia	menorrhagia
addres	adders
wasp	wasp
geneologies	genealogies
recieving	receiving
rendezous	rendezvous
probalibity	probability
crusies	cruises
incompetant	incompetent
missisipi	mississippi
inadvertantly	inadvertently
hallmark	hallmark
alotted	allotted
sweetooth	sweet tooth
compulsery	compulsory
existance	existence
surley	surly
howver	however
medline	medline
itac	itac
peoms	poems
marraige	marriage
strenous	strenuous
relized	realised
afficionados	aficionados
palce	place
trips	trips
geneological	genealogical
bishishims	bishishim
parks	parks
litterally	literally
propogates	propagates
ultracapacitors	ultracapacitors
mysogynist	misogynist
motiviated	motivated
thyat	that
enviornment	environment
deliberatly	deliberately
addresing	addressing
abortificant	abortifacient
necesary	necessary
radiall	radiall
engeneering	engineering
expalin	explain
interpet	interpret
cerimony	ceremony
eyars	years
negociation	negotiation
responsibilites	responsibilities
paralell	parallel
comparitively	comparatively
ahve	have
gynazole	gynazole
sionist	zionist
forsaw	foresaw
inofficial	unofficial
coctail	cocktail
indigineous	indigenous
allergy	allergy
preclampsia	preeclampsia
sikorskycareers	sikorsky careers
reward	reward
yahoo	yahoo
trion	trion
clarithromyc	clarithromycin
noteriety	notoriety
territorist	terrorist
villin	villein
virginity	virginity
pronouced	pronounced
philisophical	philosophical
acused	accused
miltary	military
nyse	nyse
hypnopics	hypnopics
expeced	expected
descendands	descendants
volounteers	volunteers
spermshack	sperm shack
exelent	excellent
sonic	sonic
pears	pears
imagery	imagery
amking	making
genialia	genitalia
bme	bme
add	add
professer	professor
overwelming	overwhelming
idesa	ides
adressing	dressing
approachs	approaches
inevatible	inevitable
actualy	actually
movei	movie
whther	whether
achivements	achievements
guaduloupe	guadeloupe
brickipedia	brickipedia
accomodating	accommodating
excact	exact
woman	woman
cenveo	cenveo
icmp	icmp
sieze	size
riedel	riedel
beggin	begging
slaughterhouse	slaughterhouse
bromelain	bromelain
testostrone	testosterone
acoholic	alcoholic
unsubstanciated	unsubstantiated
writen	written
contaiminate	contaminate
rupay	rupay
michagan	michigan
exagerrate	exaggerate
reflexes	reflexes
bandwith	bandwidth
uncompetive	uncompetitive
progrom	pogrom
politics	politics
ferritin	ferritin
tgirl	tgirl
marquette	marquette
acccused	accused
everthing	everything
facilites	facilities
tuscon	tucson
essentialy	essentially
achivement	achievement
degrate	degrade
penerator	penetrator
segementation	segmentation
citic	citic
perphas	perhaps
dembski	dembski
benifits	benefits
hypocricy	hypocrisy
madison	madison
mathematicas	mathematics
radon	radon
tlaking	talking
requirment	requirement
withdrawl	withdrawal
seacomm	seacomm
insensative	insensitive
negligable	negligible
shgc	shgc
consern	concern
atributes	attributes
surplanted	supplanted
basicaly	basically
restaraunteur	restaurateur
europian	european
sourthern	southern
secretery	secretary
gaurantees	guarantees
moderm	modem
restylane	restylane
kingdomhearts2	kingdom hearts 2
noncombatents	noncombatants
doccument	document
gaurd	guard
pomegranite	pomegranate
competion	competition
wetland	wetland
mysogyny	misogyny
oftenly	often
dvvisa	dv visa
harrasses	harassed
immitator	imitator
homogeneized	homogenized
adquired	acquired
noni	noni
intepretator	interpretor
multiplers	multipliers
comphrehensive	comprehensive
millenial	millennial
legitmate	legitimate
guatemala	guatemala
constituants	constituents
cryocautery	cryocautery
inclreased	increased
sucesion	succession
retreive	retrieve
altho	although
zooepidemicus	zooepidemicus
itunes	itunes
capible	capable
propmted	prompted
crtical	critical
judaism	judaism
iwll	will
afficionado	aficionado
stennis	stennis
stange	strange
powerfull	powerful
minature	miniature
orded	ordered
trancendent	transcendent
motorola	motorola
telelevision	television
tradionally	traditionally
hierachy	hierarchy
repatition	repetition
camco	camco
mistery	mystery
nfcu	nfcu
bonnano	bonanno
teenytop	teenytop
yanez	yanez
efavirenz	efavirenz
resembelance	resemblance
agred	agreed
alomst	almost
apenines	apennines
longitudonal	longitudinal
mkea	make
pinapple	pineapple
name	name
reccomendations	recommendations
dimentional	dimensional
detremental	detrimental
responce	response
pecker	pecker
addoptive	adoptive
manouverability	manoeuverability
poeoples	peoples
officaly	officially
aginst	against
extraterrestials	extraterrestrials
rythim	rhythm
xnx	xnxx
omniverous	omnivorous
readwritenow	read write now
giantcell	giant cell
acheive	achieve
aggresive	aggressive
chase	chase
certian	certain
knifes	knives
disobediant	disobedient
job	job
assemple	assemble
maglocen	magloclen
demolision	demolition
soliliquy	soliloquy
manateecounty	manatee county
sheat	sheath
h	h
socalism	socialism
venemous	venomous
trafficing	trafficking
suceed	succeed
usps	usps
guttaral	guttural
roubdioux	rubidoux
contendor	contender
becamae	became
exeptional	exceptional
mgmt	mgmt
governer	governor
reelkiddymov	reelkiddymov
miniscule	minuscule
essesital	essential
playwrites	playwrights
sanctions	sanctions
ganster	gangster
rats	rats
dependant	dependent
paralely	parallelly
unsuprizingly	unsurprisingly
emirates	emirates
swaer	swear
stickam	stickam
enviornmentalist	environmentalist
dependance	dependence
comander	commander
manuevers	maneuvers
pennelec	penelec
tongiht	tonight
variey	variety
thast	that
israelies	israelis
aslo	also
borke	broke
e	e
resssurecting	resurrecting
pumkin	pumpkin
fidn	find
h6pd	h6pd
runnung	running
desparate	desperate
formaly	formally
jugs	jugs
uneccesary	unnecessary
guiness	guinness
triology	trilogy
rebounce	rebound
controvery	controversy
russion	russian
dmso	dmso
comisions	commissions
lowes	lowes
vaccume	vacuum
ldysl	ldysl
possition	position
uproar	uproar
boxes	boxes
arguement	argument
abreviated	abbreviated
councellor	counselor
spectauclar	spectacular
accordeon	accordion
conciousness	consciousness
posseses	possesses
cummins	cummins
sionists	zionists
russina	russian
aquire	acquire
archiac	archaic
fransiscans	franciscans
recomended	recommended
satrical	satirical
alchoholic	alcoholic
snoqualmie	snoqualmie
bondagesex	bondage sex
curves	curves
independance	independence
imagin	imagine
roberts	roberts
commisioner	commissioner
qvc	qvc
mathmaticians	mathematicians
conservitive	conservative
regulaion	regulation
palce	palace
bofa	bofa
initally	initially
capturd	captured
permenantly	permanently
c	c
addmission	admission
privelege	privilege
shouldnt	shouldn t
fatc	fact
settlment	settlement
ustoy	us toy
mustangsmustangs	mustangsmustangs
scrapbook	scrapbook
nuculear	nuclear
bcc	bcc
binoculars	binoculars
excercise	exercise
resturant	restaurant
convertables	convertibles
admendment	amendment
theilluminatingcompany	the illuminating company
monestary	monetary
bedfordcountypolice	bedford county police
televsion	television
bernouilli	bernoulli
tehy	they
blessure	blessing
yelp	yelp
sexplayboy	sex playboy
tiedtoons	tiedtoons
aicpa	aicpa
loosing	losing
primarly	primarily
enviornments	environments
unoffical	unofficial
critisize	criticise
noteable	notable
wcs	wcs
indefineable	undefinable
landscapes	landscapes
cng	cng
idiosyncracy	idiosyncrasy
scinece	science
maked	made
whether	whether
exmaple	example
guidence	guidance
algoritms	algorithms
amerliorate	ameliorate
dispostion	disposition
gurantee	guarantee
mydocalm	mydocalm
churchs	churches
sars	sars
newspaper	newspaper
higway	highway
amalgamated	amalgamated
rent	rent
oanda	oanda
galations	galatians
marmelade	marmalade
diphtong	diphthong
conneticut	connecticut
releiver	reliever
suppliementing	supplementing
hallowean	hallowe en
quicklyu	quickly
shiping	shipping
headquatered	headquartered
whihc	which
magnetic	magnetic
hsbc	hsbc
hieght	height
todya	today
wdkx	wdkx
sepulcre	sepulcher
qutie	quite
aplied	applied
lobotomy	lobotomy
critized	criticized
laguage	language
detroit	detroit
what	what
subsquent	subsequent
harassement	harassment
astalavista	astalavista
quark	quark
italianette	italianette
parituclar	particular
thsi	this
tyranies	tyrannies
conquerers	conquerors
znzz	znzz
disparingly	disparagingly
gothenberg	gothenburg
stuggling	struggling
compusa	compusa
cornmitted	committed
fufill	fulfill
larrry	larry
condoms	condoms
guerillas	guerrillas
neolitic	neolithic
illegimacy	illegitimacy
net	net
yahoogames	yahoo games
attitide	attitude
representive	representative
drnik	drink
fightings	fighting
erally	really
disapointing	disappointing
asssassans	assassins
dieties	deities
theri	their
undergroundstoragetanks	underground storage tanks
emmisarry	emissary
setin	setin
isorbide	isosorbide
headquarer	headquarter
diabeties	diabetes
ab60	ab60
dicovers	discovers
spanishtranslation	spanish translation
husban	husband
documenatry	documentary
occuring	occurring
millepede	millipede
strictist	strictest
popoulation	population
accomodate	accommodate
commmemorated	commemorated
gamaglobulin	gamma globulin
housr	house
reguarly	regularly
genetics	genetics
vaieties	varieties
sucesses	successes
phonecian	phoenecian
herad	hera
thumbzilla	thumbzilla
neccessities	necessities
electon	election
receving	receiving
fudge	fudge
sytle	style
onyl	only
wnct	wnct
morrocco	morocco
emu	emu
recieve	receive
sypmtoms	symptoms
expierence	experience
proclaimation	proclamation
meningroma	meningioma
rigourous	rigorous
anyhwere	anywhere
appartment	apartment
severley	severely
coastguard	coast guard
procedger	procedure
extentions	extensions
assassintation	assassination
clasically	classically
googlenewa	google news
ctb	ctb
gatlinburg	gatlinburg
watertown	watertown
availble	available
benifit	benefit
techician	technician
exibition	exhibition
jamaica	jamaica
baycitytimes	bay city times
torymidae	torymidae
forunner	forerunner
deviantart	deviantart
poker	poker
vyre	very
dimesnional	dimensional
flamable	flammable
additionality	additionality
volonteered	volunteered
puritannical	puritanical
remaing	remaining
agregate	aggregate
persuit	pursuit
aquaintance	acquaintance
proclamed	proclaimed
comissioner	commissioner
diferrent	different
fufilled	fulfilled
acadamy	academy
evista	evista
univesity	university
sponzored	sponsored
clock	clock
meperidine	meperidine
strenghten	strengthen
yeast	yeast
finch	finch
containes	contains
graphite	graphite
garnison	garrison
withdrawl	withdraw
preperations	preparations
blountsville	blountsville
alledgedly	allegedly
idealogies	ideologies
beatiful	beautiful
fucntioning	functioning
pavillion	pavilion
ther	the
imiquimod	imiquimod
socities	societies
dominent	dominant
dissobediant	disobedient
abbywinters	abby winters
gymboree	gymboree
clera	sclera
myr	myr
libell	libel
belive	believe
commisioned	commissioned
ocurrence	occurrence
printables	printables
adoptions	adoptions
patterns	patterns
beyonce	beyonce
vegatarian	vegetarian
interpreter	interpreter
guatamalan	guatemalan
aerogel	aerogel
naturually	naturally
abundancies	abundances
conspiracys	conspiracies
cleareance	clearance
wholey	wholly
substraction	subtraction
guilia	giulia
ocassions	occasions
sparrow	sparrow
sacrafice	sacrifice
moeny	money
maintinaing	maintaining
occurances	occurrences
indisputible	indisputable
hiltonheadislandsc	hilton head island sc
bedroom	bedroom
mosture	moisture
vyer	very
referrs	refers
powerchevrolet	power chevrolet
aproximately	approximately
videofrog	videofrog
hygeine	hygiene
watches	watches
zemplar	zemplar
equivilant	equivalent
forseeable	foreseeable
aggreed	agreed
alochol	alcohol
posessing	possessing
binominal	binomial
inadquate	inadequate
messenging	messaging
supplamented	supplemented
316	316
infalability	infallibility
transcendance	transcendence
iresistible	irresistible
filefront	filefront
fransiscan	franciscan
imanent	eminent
anomoly	anomaly
myelodysplastic	myelodysplastic
ideosyncratic	idiosyncratic
interchangably	interchangeably
ditributed	distributed
adminstrator	administrator
percieve	perceive
iminent	imminent
paxil	paxil
critisizing	criticizing
benzene	benzene
bouyancy	buoyancy
settelement	settlement
aciphex	aciphex
artifically	artificially
culture	culture
propogation	propagation
terazosine	terazosin
rccl	rccl
meterologist	meteorologist
privilage	privilege
shiped	shipped
sconex	sconex
therafter	thereafter
recipiants	recipients
exampt	exempt
liscense	license
develope	develop
disatisfaction	dissatisfaction
essentual	essential
thast	that s
unilateraly	unilaterally
wsdol	wsdol
preceeded	preceded
symetrically	symmetrically
cheesecake	cheesecake
polygonum	polygonum
origanaly	originally
beleive	believe
engineering	engineering
adderall	adderall
27	27
fosinopril	fosinopril
amke	make
pakistan	pakistan
jewllery	jewellery
alusion	illusion
kenzerco	kenzerco
controlls	controls
leage	league
cnn	cnn
inbalanced	imbalanced
poltical	political
excelent	excellent
surrended	surrounded
vengance	vengeance
popularaty	popularity
exhalted	exalted
councellors	councillors
signifigantly	significantly
euclid	euclid
ommiting	omitting
stroy	destroy
mailbox	mailbox
unsuccesfully	unsuccessfully
authoritive	authoritative
effulence	effluence
releived	relieved
rabbi	rabbi
unnecesary	unnecessary
tyrrany	tyranny
anixter	anixter
thna	than
controversey	controversy
airbourne	airborne
rigeur	rigour
strnad	strand
gmail	gmail
amature	amateur
nickle	nickel
milion	million
misfourtunes	misfortunes
doesnt	doesn t
tast	taste
missourilottery	missouri lottery
populare	popular
consolodate	consolidate
ski	ski
work	work
poluted	polluted
effords	efforts
throughly	thoroughly
despatched	dispatched
amung	among
proximty	proximity
initiaitive	initiative
propotions	proportions
electic	eclectic
arround	around
paralelly	parallelly
balanitis	balanitis
hellhound	hellhound
formost	foremost
auxillary	auxiliary
streemlining	streamlining
derivitive	derivative
yatch	yacht
labatory	lavatory
reccommending	recommending
excecute	execute
sergent	sergeant
dael	dial
admissable	admissible
drudgereport	drudge report
diy	diy
excecution	execution
torpedos	torpedoes
desorder	disorder
compatablities	compatibilities
zootube365	zootube365
managable	manageable
mikids	mikids
caponography	capnography
explore	explore
entrepeneurs	entrepreneurs
cervial	serval
vasoseal	vasoseal
honda	honda
automaticly	automatically
gropu	group
referiang	referring
simpley	simply
imaginery	imaginary
chemestry	chemistry
implimented	implemented
identifers	identifiers
emt	emt
remenicent	reminiscent
inspite	inspire
funguses	fungi
repid	rapid
taxi	taxi
presumabely	presumably
shrimp	shrimp
attemp	attempt
spritual	spiritual
tourch	touch
moent	moment
belligerant	belligerent
diphtongs	diphthongs
asthetically	aesthetically
reproducable	reproducible
massachussets	massachusetts
beseige	besiege
canaan	canaan
nessasarily	necessarily
supposingly	supposedly
consorcium	consortium
organim	organism
manouverable	manoeuvrable
excellant	excellent
wildfire	wildfire
lift	lift
sicne	since
hpdm	hpdm
yementite	yemeni
stirrs	stirs
volkswagen	volkswagen
yermo	yermo
dictinary	dictionary
pinoneered	pioneered
identicial	identical
anounced	announced
fisionable	fissionable
allegedy	allegedly
carcas	carcass
practioner	practitioner
null	null
eigth	eighth
coridal	cordial
inpeach	impeach
apprearance	appearance
comiting	committing
regalrailing	regal railing
leanr	lean
costumes	costumes
tmobile	t mobile
recomending	recommending
mylol	mylol
vengence	vengeance
soverignty	sovereignty
dimentions	dimensions
rininging	ringing
jayski	jayski
incompatiblities	incompatibilities
utswmc	utswmc
algebraical	algebraic
tattoo	tattoo
deram	dram
conciders	considers
appealling	appealing
universtiy	university
comissioning	commissioning
awya	away
shamrock	shamrock
familliar	familiar
erally	orally
acquiantences	acquaintances
progestin	progestin
descriibes	describes
typicaly	typically
livebirths	live births
neomycin	neomycin
throught	through
survivers	survivors
fiel	phial
phones	phones
spectaulars	spectaculars
yuo	you
critisizes	criticizes
faciliates	facilitates
mitrofanoff	mitrofanoff
addressess	addresses
ethnocentricm	ethnocentrism
frus	frus
affilliate	affiliate
phenomenom	phenomenon
muriqi	muriqi
verizion	verizon
neice	nice
16223t	16223t
ikea	ikea
stong	strong
beween	between
unrepentent	unrepentant
suseptible	susceptible
commuications	communications
difficulity	difficulty
yaching	yachting
pfuer	pfuer
forbiden	forbidden
rythm	rhythm
definatly	definitely
sieze	seize
lcm	lcm
existince	existence
cockatiels	cockatiels
controveries	controversies
somene	someone
prooved	proved
responisble	responsible
boxhead	boxhead
comemmorates	commemorates
doctines	doctrines
harased	harassed
signfies	signifies
unplease	displease
relized	realized
cant	cannot
lav	lav
extered	exerted
collecton	collection
zipcodefinder	zip code finder
infilitrate	infiltrate
govenrment	government
pratice	practice
autority	authority
oldies	oldies
wholy	wholly
abutts	abuts
ucconline	ucc online
unathorised	unauthorised
tiome	time
fusion	fusion
spectrol	spectrol
rudetube	rude tube
villify	vilify
compatablity	compatibility
centruy	century
occurr	occur
electricly	electrically
omre	more
fedbizopps	fedbizopps
docrines	doctrines
volunteerism	volunteerism
aisian	asian
nothern	northern
aforememtioned	aforementioned
assasined	assassinated
travelodge	travelodge
cooley	cooley
enourmously	enormously
planation	plantation
intrest	interest
critizing	criticizing
influented	influenced
atenelol	atenolol
recivership	receivership
cow	cow
frome	from
archeaologists	archaeologists
decomposits	decomposes
polinators	pollinators
abilty	ability
morocco	morocco
menally	mentally
desireable	desirable
eveyr	every
critisism	criticism
diferent	different
accomodated	accommodated
pacsun	pacsun
rentors	renters
admitedly	admittedly
annualy	annually
instuction	instruction
ocasion	occasion
unlocker	unlocker
emminently	eminently
mutiliated	mutilated
practioners	practitioners
imagenary	imaginary
virginia	virginia
distingishing	distinguishing
mariaparhamhospital	maria parham hospital
timex	timex
fertily	fertility
recived	received
ata	ata
rwite	write
critisize	criticize
billingualism	bilingualism
pallete	palette
loudoun	loudoun
contemporaneus	contemporaneous
speachless	speechless
historicians	historians
ud	ud
driectly	directly
curch	church
meyyappan	meyyappan
chemotherpy	chemotherapy
distingishes	distinguishes
pers	pers
emersonretailsolutions	emerson retail solutions
nasdqu	nasdaq
szafarz	szafarz
proove	prove
seperation	separation
possiblility	possibility
indispensible	indispensable
journies	journeys
rps	rps
detethering	detethering
wackford	wackford
kabatogama	kabetogama
lactoferrin	lactoferrin
grasshoppers	grasshoppers
beggins	begins
botulismo	botulism
gottleib	gottlieb
suposing	supposing
ansalisation	nasalisation
delusionally	delusively
adresable	addressable
prednisolone	prednisolone
exagerrated	exaggerated
physics	physics
lieing	lying
bogota	bogota
restauraunt	restaurant
nkwo	know
jjrc	jjrc
sence	sense
tripadvisor	tripadvisor
embargos	embargoes
tahn	than
definitly	definitely
naturaly	naturally
moil	mohel
montypic	monotypic
cantrol	control
subtances	substances
sprint	sprint
suceeds	succeeds
propper	proper
fiels	files
reciever	receiver
yemen	yemen
unweildly	unwieldy
truliant	truliant
ksop	ksop
swaneze	swaneze
expropiation	expropriation
ecidious	deciduous
adjacent	adjacent
iresistable	irresistible
againnst	against
exonorate	exonerate
authorites	authorities
pffcu	pffcu
levetates	levitates
intrduced	introduced
dicovered	discovered
ebern	ebern
captued	captured
855b	855b
noteably	notably
wendsay	wednesday
eotech	eotech
phillosophically	philosophically
iminent	immanent
avastin	avastin
tra	tra
heterogenous	heterogeneous
evidentally	evidently
priviledges	privileges
posthomous	posthumous
geometricians	geometers
undecideable	undecidable
unsed	used
foodstamp	food stamp
synphony	symphony
retalitated	retaliated
febetra	febetra
avast	avast
comprable	comparable
uga	uga
alaska	alaska
similiar	similar
comisioner	commissioner
fta	fta
obediant	obedient
women	women
ahev	have
prominately	predominately
provinicial	provincial
croatia	croatia
flagstone	flagstone
deparment	department
fluticasone	fluticasone
aeriel	aerial
mischevious	mischievous
tendancies	tendencies
dispicable	despicable
quarantaine	quarantine
ficticious	fictitious
paitience	patience
caisa	caisa
auxilary	auxiliary
lisence	license
villian	villain
surrended	surrendered
archaelogists	archaeologists
austrailia	australia
government	government
spermatozoan	spermatozoon
consituencies	constituencies
owudl	would
refrences	references
escopolamina	escopolamina
concious	conscious
anual	anal
psyhic	psychic
britian	britain
competative	competitive
idaeidae	idea
additions	additions
vasall	vassal
barberry	barberry
disenchanged	disenchanted
hwole	whole
enviroments	environments
componant	component
mandalaybayresort	mandalay bay resort
toysruscom	toysrus com
strenghening	strengthening
apperances	appearances
circulaton	circulation
googel	google
dissappears	disappears
consentrate	concentrate
conspiriator	conspirator
clas	class
centruies	centuries
shorly	shortly
cartoonnetworkcom	cartoonnetwork com
neice	niece
recomend	recommend
seperates	separates
asetic	ascetic
athiest	atheist
blboys	blboys
vincinity	vicinity
simmilar	similar
renedered	rende
octohedral	octahedral
suseptable	susceptible
prairy	prairie
usda	usda
offred	offered
rashes	rashes
breif	brief
exerciese	exercises
ncsecu	ncsecu
questonable	questionable
consdidered	considered
intervines	intervenes
amend	amend
fraze	fraze
wordlwide	worldwide
kaiser	kaiser
fourties	forties
pr0n	pr0n
abalone	abalone
sedereal	sidereal
rised	rose
dimenions	dimensions
inflamation	inflammation
angels	angels
storm	storm
entertaners	entertainers
agressive	aggressive
meigscounty	meigs county
vleta	vleta
veyr	very
enforceing	enforcing
consdider	consider
macys	macy s
wheras	whereas
bcak	back
createagraph	create a graph
familes	families
garanteed	guaranteed
eligable	eligible
nickleback	nickelback
lible	liable
plesant	pleasant
muercury	mercury
pspvc	pspvc
voc	voc
noticible	noticeable
negociations	negotiations
ask	ask
jlo	jlo
endoscopic	endoscopic
posion	poison
recieved	received
jospeh	joseph
exagerate	exaggerate
immitating	imitating
criterias	criteria
aflatoxin	aflatoxin
warantee	warranty
twpo	two
perogative	prerogative
laguages	languages
probelm	problem
similiarly	similarly
exinct	extinct
sheat	cheat
vulnerablility	vulnerability
unconciousness	unconsciousness
penisular	peninsular
earthquake	earthquake
neck	neck
litature	literature
behavour	behavior
casion	caisson
malcom	malcolm
nicvax	nicvax
ocuntries	countries
demographical	demographic
ticketmaster	ticketmaster
univeral	universal
choramphenicol	chloramphenicol
transending	transcending
florescent	fluorescent
cassini	cassini
compatable	compatible
armamant	armament
papanicalou	papanicolaou
designer	designer
ross	ross
cabosanlucas	cabo san lucas
dighton	dighton
propietary	proprietary
exagerated	exaggerated
snowboarding	snowboarding
indepedantly	independently
sufferring	suffering
unrepetant	unrepentant
ocasionaly	occasionally
cox	cox
invertibrates	invertebrates
villageofpalmettobay	village of palmetto bay
pretection	protection
temperture	temperature
begining	beginning
nara	nara
pretty	pretty
indpendent	independent
manufacturedd	manufactured
amforal	amforol
avaliable	available
anonimity	anonymity
liek	like
incredibles	incredibles
agre	agree
thigmotropism	thigmotropism
hog	hog
kandinsky	kandinsky
govormental	governmental
transunion	transunion
engeneer	engineer
gladewater	gladewater
hounour	honour
achived	achieved
sheild	shield
newgrounds	newgrounds
parellels	parallels
tath	that
imigrant	emigrant
indefinately	indefinitely
lybia	libya
5up	5up
5150	5150
fomr	from
hdtvcolorado	hdtv colorado
slipcovers	slipcovers
subsquently	subsequently
xh	xh
pyscic	psychic
protruberance	protuberance
critisizing	criticising
meterology	meteorology
bayonne	bayonne
zoo	zoo
offically	officially
ghandi	gandhi
notch	notch
disapeared	disappeared
instyle	instyle
rhythim	rhythm
vamc	vamc
reminsicent	reminiscent
assisnate	assassinate
implamenting	implementing
profesion	profusion
critisized	criticized
inagurated	inaugurated
brittish	british
parkinsonism	parkinsonism
liscense	licence
bodydbuilder	bodybuilder
juristiction	jurisdiction
illiegal	illegal
graet	great
walmart	walmart
consenquently	consequently
gutteral	guttural
charachters	characters
alcohal	alcohol
publicsexoffenders	public sex offenders
reptition	repetition
peageant	pageant
northwestbackroads	northwest backroads
champange	champagne
surprized	surprised
excecuting	executing
conqured	conquered
cocaine	cocaine
relevence	relevance
grat	great
equiped	equipped
knowlege	knowledge
rsat	rsat
feromone	pheromone
guerrila	guerrilla
mpri	mpri
elavil	elavil
muder	murder
controvercial	controversial
incomptetent	incompetent
knwos	knows
psuedo	pseudo
medevial	medieval
oppositition	opposition
outsourcing	outsourcing
wroking	working
verizon	verizon
countains	contains
alwasy	always
jstu	just
nchwa	nchwa
notdoler	notdoppler
rigid	rigid
puppies	puppies
gaurentee	guarantee
contamporary	contemporary
troup	troupe
denegrating	denigrating
acquaintences	acquaintances
averageed	averaged
relinqushment	relinquishment
arbonne	arbonne
congresional	congressional
compatabilities	compatibilities
iresistibly	irresistibly
foootball	football
lingerie	lingerie
philosphy	philosophy
epistaxis	epistaxis
mathamatics	mathematics
reliablity	reliability
equivilent	equivalent
alleles	alleles
rigeur	rigor
irbc	irbc
individualy	individually
ebay	ebay
consumate	consummate
emited	emitted
chris	chris
possibilty	possibility
happend	happened
petechiae	petechiae
corperations	corporations
exagerrates	exaggerates
decidely	decidedly
artinude	artinude
nixon	nixon
usics	uscis
sheds	sheds
showtime	showtime
lonley	lonely
smis	smis
exchanching	exchanging
evaporation	evaporation
decribes	describes
doign	doing
helment	helmet
megaupload	megaupload
liftime	lifetime
missonary	missionary
scandanavia	scandinavia
ngemc	ngemc
adbandon	abandon
receeding	receding
eqal	eqal
hip	hip
provicial	provincial
revolutionary	revolutionary
guerilla	guerrilla
wildcats	wildcats
hwihc	which
agressively	aggressively
limewire	limewire
vigeur	vigor
busineses	business
omlette	omelette
peom	poem
oscar	oscar
exerpt	excerpt
fictious	fictitious
elimentary	elementary
exerternal	external
mysef	myself
wolves	wolves
archetecture	architecture
liasion	liaison
steelers	steelers
poulations	populations
cerfp	cerfp
modle	model
succeded	succeeded
perjery	perjury
knive	knife
eventially	eventually
collonies	colonies
tridenthealthsystems	trident health systems
dissapear	disappear
breakthough	breakthrough
strenghtened	strengthened
kontraband	kontraband
xanax	xanax
recident	resident
montains	mountains
vacation	vacation
njsdoe	njdoe
cattleship	battleship
hsitorians	historians
hapened	happened
myfreechecking	my free checking
incomptable	incompatible
beswick	beswick
bes	bes
atlantageorgialowincomehousing	atlanta georgia low income housing
farenheit	fahrenheit
acedemic	academic
hydogen	hydrogen
airporta	airports
johanine	johannine
broadacasting	broadcasting
crossfit	crossfit
critereon	criterion
cahracters	characters
phylosophical	philosophical
eahc	each
proffesion	profession
twinvest	twinvest
medicine	medicine
cemetarey	cemetery
verbena	verbena
alwyas	always
boulard	boulard
chuch	church
contamporaries	contemporaries
jeapardy	jeopardy
myspace	myspace
equippment	equipment
skull	skull
seagrass	seagrass
monserrat	montserrat
relativly	relatively
illegitmate	illegitimate
agrieved	aggrieved
sterieo	stereo
levalbuterol	levalbuterol
regardes	regards
beccause	because
hippie	hippie
hysterectomy	hysterectomy
targetting	targeting
trustees	trustees
eyars	eyas
woodpecker	woodpecker
diversed	diverged
foundary	foundry
illution	illusion
poodlerescue	poodle rescue
kimono	kimono
sprech	speech
coq10	coq10
ressurected	resurrected
accompanyed	accompanied
kindomheartscheats	kingdom hearts cheats
theif	thief
sanctionning	sanctioning
alternitives	alternatives
carmax	carmax
geneaology	genealogy
alledge	allege
htey	they
adobephotoshop	adobe photoshop
waggener	waggener
tdcj	tdcj
harrasing	harassing
fabtech	fabtech
neccesary	necessary
reasearch	research
unsucesful	unsuccessful
provisonal	provisional
agefiph	agefiph
investingate	investigate
poverful	powerful
guaduloupe	guadalupe
unfourtunately	unfortunately
alege	allege
procedes	precedes
corosion	corrosion
lipoma	lipoma
competion	completion
tonsilectomy	tonsillectomy
dessigned	designed
throatjobs	throat jobs
cars	cars
accomodation	accommodation
succsessfull	successful
xanthomonas	xanthomonas
aledges	alleges
travelzoo	travelzoo
shadowlands	shadowlands
nikego	nikego
amoungst	amongst
ethose	ethos
dogs	dogs
adminstered	administered
hwile	while
runescape2	runescape 2
faciliated	facilitated
portayed	portrayed
acomplishments	accomplishments
guarentee	guarantee
pamplet	pamphlet
peopel	people
satire	satire
referrence	reference
areodynamics	aerodynamics
ganerate	generate
parrallel	parallel
inbetween	between
sponser	sponsor
generatting	generating
altough	although
demostration	demonstration
dichtomy	dichotomy
safety	safety
photographer	photographer
werewolf	werewolf
aborigene	aborigine
alledges	alleges
sphincter	sphincter
peotry	poetry
predicitons	predictions
tyhe	they
syas	says
perjorative	pejorative
imap	imap
shineing	shining
ancestor	ancestor
lenalidomide	lenalidomide
milennia	millennia
minstries	ministries
potatos	potatoes
scirpt	script
exicting	exciting
critisized	criticised
orignially	originally
maked	marked
census	census
prestigous	prestigious
ame	ame
greentop	greentop
sacreligious	sacrilegious
concretehomes	concrete homes
haev	have
adquire	acquire
gams	gams
premeired	premiered
imanent	imminent
incorruptable	incorruptible
obstacal	obstacle
tenants	tenants
suprizing	surprising
thediamondgroup	the diamond group
thign	thing
dissobedient	disobedient
trefsger	trefsger
beaches	beaches
possesion	possession
naha	naha
eletricity	electricity
substancial	substantial
consentrated	concentrated
accordian	accordion
snor	snor
myraid	myriad
emmisaries	emissaries
unmanouverable	unmanoeuvrable
turnk	trunk
biafine	biafine
arguements	arguments
possable	possible
orginize	organise
n2len	n2len
recogise	recognise
hyperoxaluria	hyperoxaluria
inumerable	innumerable
infomation	information
flames	flames
godounov	godunov
watn	want
embarassed	embarrassed
br	br
oxyfresh	oxyfresh
harrassing	harassing
childen	children
instutionalized	institutionalized
beatles	beatles
screensaver	screensaver
programable	programmable
haviest	heaviest
traditionaly	traditionally
paide	paid
m16	m16
manouverable	maneuverable
charasmatic	charismatic
ajb	ajb
mantis	mantis
mathmatically	mathematically
aquisition	acquisition
cadasil	cadasil
leaded	led
consistant	consistent
claer	clear
nicegirls	nice girls
foucs	focus
enteratinment	entertainment
selena	selena
archtypes	archetypes
architechturally	architecturally
hydropobic	hydrophobic
extermist	extremist
huminoid	humanoid
occurences	occurrences
vermicomposting	vermicomposting
surounded	surrounded
despict	depict
tyrranies	tyrannies
somnifacient	somnifacient
nuremburg	nuremberg
bo	bo
convienient	convenient
mantained	maintained
x24xx	x24xx
succesion	succession
unsucessful	unsuccessful
megace	megace
combinatins	combinations
trax	trax
furuther	further
essentail	essential
aggaravates	aggravates
accessable	accessible
campinas	campinas
rehersal	rehearsal
secceeded	succeeded
guilio	giulio
neigbours	neighbors
achived	archived
wrok	work
providencepheonix	providence phoenix
bedore	before
reconized	recognized
mussel	mussel
lipan	lipan
liquify	liquefy
acquited	acquitted
afair	affair
propoganda	propaganda
boaut	bout
namenda	namenda
priya	priya
interchangable	interchangeable
procede	precede
safeco	safeco
orignally	originally
prominance	prominence
manouverability	manoeuvrability
abilties	abilities
disappearred	disappeared
stoyr	story
collony	colony
guadulupe	guadalupe
ocasions	occasions
mrpeepers	mr peepers
vell	well
cdw	cdw
centralcollections	central collections
attrocities	atrocities
phenomenonal	phenomenal
etl	etl
primordal	primordial
exempt	exempt
undergear	undergear
threshhold	threshold
reigining	reigning
traditition	tradition
beyonder	beyonder
obession	obsession
voorhees	voorhees
sohw	show
zakat	zakat
banned	banned
tommorow	tomorrow
withold	withhold
alsot	also
uninterupted	uninterrupted
hamburger	hamburger
decieved	deceived
offereings	offerings
scabe	scabe
vacuumsweepers	vacuum sweepers
pased	passed
generaly	generally
vigilence	vigilance
8880	8880
piratesdinneradventure	pirates dinner adventure
progroms	programs
addres	address
unavailible	unavailable
widower	widower
incidently	incidentally
multiply	multiply
wriet	write
ursula	ursula
avandia	avandia
allegedely	allegedly
ressembled	resembled
transporation	transportation
anapylaxis	anaphylaxis
somtimes	sometimes
blagojevich	blagojevich
urea	urea
caligraphy	calligraphy
decomissioned	decommissioned
comando	commando
ouevre	oeuvre
lvoe	love
idaes	ideas
galvinized	galvanized
maintioned	mentioned
agression	aggression
xenophoby	xenophobia
glucosamine	glucosamine
sinse	since
grasshopper	grasshopper
meridianksi	meridian ksi
sensure	censure
satelites	satellites
formalhaut	fomalhaut
ofelia	ofelia
hotmail	hotmail
allegence	allegiance
acheivment	achievement
earth	earth
suposes	supposes
earlies	earliest
taft	taft
uprr	uprr
passat	passat
constatn	constant
possessess	possesses
butterflies	butterflies
harasments	harassments
habaeus	habeas
halp	help
proventil	proventil
bnp	bnp
ususally	usually
uise	use
thier	their
jordans	jordans
funnypic	funny pic
speach	speech
undetecable	undetectable
emition	emotion
imdb	imdb
saterdays	saturdays
attendent	attendant
o	o
venpar	venpar
subjects	subjects
sleeping	sleeping
nuturing	nurturing
gravity	gravity
munnicipality	municipality
misdameanors	misdemeanors
sovereignity	sovereignty
suprisingly	surprisingly
acording	according
dramtic	dramatic
tdi	tdi
sould	should
appropropiate	appropriate
unsucessfully	unsuccessfully
dictonaries	dictionaries
kpdk	kpdk
referal	referral
commericially	commercially
negociate	negotiate
poconos	poconos
mascarenas	mascarenas
dc93	dc93
exagerating	exaggerating
commemmorate	commemorate
heigher	higher
addopted	adopted
stroy	story
restauration	restoration
archetectural	architectural
coolmaths	cool maths
hostage	hostage
begginer	beginner
decendent	descendant
tiem	tim
kenai	kenai
sufferage	suffrage
messanger	messenger
posessions	possessions
muncipalities	municipalities
eratically	erratically
facist	fascist
portuguease	portuguese
preverse	perverse
mavik	mavik
soverignity	sovereignty
rendevous	rendezvous
calaber	caliber
aaos	aaos
rutein	rutein
maintance	maintenance
satrically	satirically
uaw	uaw
decendents	descendants
plantiff	plaintiff
virtualy	virtually
repetion	repetition
whta	what
independantly	independently
progranulin	progranulin
gamestop	gamestop
cypress	cypress
tzeltal	tzeltal
dissobedience	disobedience
munbers	numbers
midwest	midwest
upgradded	upgraded
govornment	government
phenylpropanolamine	phenylpropanolamine
calulate	calculate
radify	ratify
gawg	gawg
unconvential	unconventional
nkow	know
lymphoid	lymphoid
pappas	pappas
performes	performed
convenant	covenant
diminuitive	diminutive
bussiness	business
bulgari	bulgari
cartdridge	cartridge
calulated	calculated
demenor	demeanor
possiblilty	possibility
minerial	mineral
hydropile	hydrophile
vardenafil	vardenafil
htis	this
pucini	puccini
accademy	academy
unforgiveable	unforgivable
seached	searched
soveits	soviets
scientifc	scientific
misdemenors	misdemeanors
ukranian	ukrainian
divitulitis	divitulitis
divison	division
traditionnal	traditional
minimodels	mini models
comitted	committed
repsectively	respectively
adam4	adam4
ejaculation	ejaculation
seach	search
proceded	proceeded
schneiderian	schneiderian
thiunk	think
prestigeous	prestigious
saintvincent	saint vincent
lippizaner	lipizzaner
marriott	marriott
fleed	fled
nasaweather	nasa weather
exercycle	exercycle
pushnik	pushnik
bearshare	bearshare
eraticly	erratically
consolodated	consolidated
appealling	appalling
harasment	harassment
thigsn	things
criticists	critics
draperies	draperies
suprizingly	surprisingly
vrey	very
dnag	dnag
netflix	netflix
redtoube	redtube
movment	movement
fundametal	fundamental
committe	committee
staion	station
wikipedia	wikipedia
pogo	pogo
aversion	aversion
caseworker	caseworker
vids	vids
national	national
metalic	metallic
usally	usually
vasalls	vassals
asside	aside
unwieldly	unwieldy
disiplined	disciplined
comming	coming
rabbit	rabbit
desktiop	desktop
draughtman	draughtsman
pleasurefest	pleasure fest
recurrance	recurrence
citizen	citizen
debka	debka
scabies	scabies
encryptiion	encryption
intertaining	entertaining
usualy	usually
transistion	transition
htere	here
exercise	exercise
chat	chat
achive	achieve
independece	independence
blaimed	blamed
opthalmic	ophthalmic
1876	1876
morisette	morissette
punding	punding
lardy	lardy
tenacles	tentacles
dipthong	diphthong
macted	macted
scuptures	sculptures
350z	350z
expressservices	express services
addresable	addressable
algorhitms	algorithms
nuisanse	nuisance
originially	originally
vigourous	vigorous
petrolatum	petrolatum
gaurantee	guarantee
infilitrated	infiltrated
abritrary	arbitrary
developped	developed
darvon	darvon
oximoron	oxymoron
techiniques	techniques
msds	msds
apperance	appearance
dictionary	dictionary
livermore	livermore
techicians	technicians
reccommend	recommend
inctroduced	introduced
id	id
communiation	communication
sotyr	satyr
bridgepainter	bridge painter
infowars	infowars
oaoa	oaoa
gleditsia	gleditsia
hvea	heave
proceding	proceeding
stratagically	strategically
rhytmic	rhythmic
pamflet	pamphlet
abc	abc
alcoholical	alcoholic
sorceror	sorcerer
critisising	criticising
commerorative	commemorative
tricophilia	trichophilia
miyavi	miyavi
cashiers	cashiers
initation	initiation
metaphoricial	metaphorical
quercitin	quercetin
toriodal	toroidal
campain	campaign
heidelburg	heidelberg
opponant	opponent
eprocrates	epocrates
geometrician	geometer
powerball	powerball
expecially	especially
eurpoean	european
spects	expects
smealting	smelting
protruberances	protuberances
imigrant	immigrant
seceeded	seceded
seperatist	separatist
dissapeared	disappeared
verfication	verification
truely	truly
pyrrhuloxia	pyrrhuloxia
fiels	fields
origional	original
rhythem	rhythm
cbsfm880	wcbs fm 880
godvd	godvd
clinicaly	clinically
inaccessable	inaccessible
tenea	tenea
efficency	efficiency
apprieciate	appreciate
phenomonenon	phenomenon
potrait	portrait
controled	controlled
cynthia	cynthia
inaugures	inaugurates
popcorn	popcorn
prams	prams
prarie	prairie
4958	4958
pinnaple	pineapple
talekd	talked
sotyr	story
occassionally	occasionally
consulant	consultant
libary	library
discribe	describe
engagment	engagement
deffensively	defensively
occurrances	occurrences
mudering	murdering
gi5fvaxvl	gi5fvaxvl
manuever	manoeuvre
recrod	record
insest	insest
empleos	empleos
constaints	constraints
programs	programs
inheritage	heritage
tadalafil	tadalafil
glycol	glycol
preriod	period
pwoer	power
compulsary	compulsory
undreground	underground
rbans	rbans
attaindre	attained
mispelling	misspelling
clinton	clinton
qutie	quiet
soudns	sounds
seperately	separately
rar	rar
severly	severely
zeebra	zebra
controling	controlling
gogin	going
healthercare	healthcare
similiarity	similarity
beginnig	beginning
poportional	proportional
develpment	development
accuweather	accuweather
descibed	described
achievment	achievement
freightek	freightek
buisness	business
fromed	formed
tempertaure	temperature
wtc7	wtc7
gae	gael
earda	earda
disatisfied	dissatisfied
obituaries	obituaries
haev	heave
beligum	belgium
ramones	ramones
religeous	religious
micca	micca
surgeon	surgeon
surprizing	surprising
conserning	concerning
exliled	exiled
gae	game
mediterainnean	mediterranean
bemusemnt	bemusement
iceworms	ice worms
wasnt	wasn t
vagifem	vagifem
accomadation	accommodation
probablistic	probabilistic
alot	allot
priorityclub	priority club
sepina	subpoena
ufos	ufos
lefted	left
vdhcd	vdhcd
htink	think
alowed	allowed
substracting	subtracting
expropiated	expropriated
uncertainity	uncertainty
artifical	artificial
cumulatative	cumulative
consultation	consultation
export	export
pronomial	pronominal
benificial	beneficial
lible	libel
diea	die
clasical	classical
flags	flags
unsuccessfull	unsuccessful
amendmant	amendment
processer	processor
unfortunatly	unfortunately
resturaunt	restaurant
supose	suppose
pictures	pictures
donig	doing
expeditonary	expeditionary
volonteering	volunteering
alliteration	alliteration
premission	permission
webbootie	webbootie
ommited	omitted
arbitary	arbitrary
napa	napa
plebicite	plebiscite
engieneers	engineers
enviormental	environmental
additinally	additionally
scleoa	scleoa
pulmaney	pulmaney
gnawwed	gnawed
beleagured	beleaguered
youseff	yousef
adressable	addressable
wayword	wayward
cincinnatti	cincinnati
mccarthyst	mccarthyist
fictionmania	fictionmania
censur	censor
pulmanologist	pulmonologist
fisma	fisma
om	om
journied	journeyed
klenex	kleenex
immediatly	immediately
mkae	make
herpes	herpes
exersize	exercise
muscels	mussels
symbols	symbols
becasue	because
negotation	negotiation
swaers	swears
veins	veins
nos	nos
greatfully	gratefully
commonweath	commonwealth
compatiable	compatible
scaleable	scalable
varity	variety
praries	prairies
obagi	obagi
wich	witch
unneccesarily	unnecessarily
temparate	temperate
assualted	assaulted
mileu	milieu
extemely	extremely
buisnessman	businessman
emmision	emission
inevitible	inevitable
appart	apart
hppt	hppt
managment	management
concerta	concerta
park	park
sountrack	soundtrack
transcripting	transcribing
gate	gate
queenland	queensland
combanations	combinations
unsucessfull	unsuccessful
detailled	detailed
glucoma	glucoma
particularily	particularly
rhabdomyolisis	rhabdomyolysis
cnet	cnet
auromated	automated
azsexoffenders	az sex offenders
accelerator	accelerator
mobis	mobis
lveo	love
eiter	either
enviorments	environments
southard	southard
duting	during
mercentile	mercantile
forbad	forbade
cato	cato
explictly	explicitly
irregardless	regardless
engieneer	engineer
visable	visible
suprised	surprised
incompatable	incompatible
recidents	residents
tremelo	tremolo
smoe	some
phillipines	philippines
sourth	south
erested	arrested
iron	iron
usefull	useful
mileau	milieu
simvastation	simvastatin
perfomers	performers
discribing	describing
terraserver	terraserver
mosida	mosida
dipthongs	diphthongs
youcalltheshots	you call the shots
caperbility	capability
eles	eels
coucil	council
controvercy	controversy
acceptence	acceptance
geneology	genealogy
brethen	brethren
ressembling	resembling
pasttime	pastime
teemaster	teemaster
succeds	succeeds
catabolic	catabolic
leanr	leaner
passerbys	passersby
restaraunts	restaurants
guatamala	guatemala
sotry	story
sucession	succession
wheelies	wheelies
superintendant	superintendent
dextromethorphan	dextromethorphan
formallized	formalized
nazereth	nazareth
devestated	devastated
restraunt	restraint
pandas	pandas
sattelites	satellites
guadulupe	guadeloupe
wokr	work
degrassi	degrassi
unconcious	unconscious
metra	metra
lillll	lillll
slowy	slowly
lieved	lived
sysmatically	systematically
authoritiers	authorities
kralendijk	kralendijk
extradiction	extradition
indexes	indexes
kegelmaster	kegelmaster
amu	amu
aeriels	aerials
garantees	guarantees
leukemia	leukemia
causalities	casualties
comissions	commissions
crystals	crystals
alligned	aligned
thne	then
heathy	healthy
sytem	system
guranteed	guaranteed
reorganision	reorganisation
macy	macy
espn	espn
celcius	celsius
equivelent	equivalent
unprecidented	unprecedented
consumated	consummated
entitlied	entitled
irreplacable	irreplaceable
parelli	parelli
proffesed	professed
congradulations	congratulations
currenly	currently
norhern	northern
ethose	those
excell	excel
rams	rams
adacel	adacel
exludes	excludes
flourescent	fluorescent
oasas	oasas
improvision	improvisation
boxercraft	boxercraft
asociated	associated
pollulert	pollulert
imigrated	immigrated
indepedence	independence
emo	emo
sucessive	successive
primatively	primitively
surrouding	surrounding
boytube	boy tube
cerimonious	ceremonious
commissions	commissions
differnt	different
facillitate	facilitate
footballhalloffame	football hall of fame
uniclic	uniclic
neigbouring	neighbouring
michaels	michaels
cingluar	cingular
kauai	kauai
thikns	thinks
incunabla	incunabula
ritenour	ritenour
hardchrome	hard chrome
descripters	descriptors
wich	which
buddishim	buddhism
iomega	iomega
carismatic	charismatic
avalance	avalanche
rocord	record
affilate	affiliate
unecessary	unnecessary
shares	shares
enlargments	enlargements
pattented	patented
conquerd	conquered
copyright	copyright
maltesian	maltese
nemo	nemo
perosnality	personality
consdiered	considered
typcial	typical
admissability	admissibility
freeone	freeone
sattelite	satellite
textuality	textuality
cant	can t
preferrably	preferably
caigslist	craigslist
sarajevo	sarajevo
lds	lds
quilting	quilting
hoarding	hoarding
hydropilic	hydrophilic
divice	device
novojoy	novojoy
rulle	rule
massachussetts	massachusetts
milkcows	milk cows
profile	profile
indespensible	indispensable
gttr	gttr
amtrack	amtrak
imigrated	emigrated
n	n
withing	within
peristent	persistent
diaster	disaster
charactersistic	characteristic
meranda	veranda
wonderfull	wonderful
sprintec	sprintec
abrahamlincoln	abraham lincoln
hierarcical	hierarchical
diney	disney
oscillococcinum	oscillococcinum
insitutions	institutions
resteraunts	restaurants
consitution	constitution
protowall	protowall
yuffie	yuffie
thru	through
permissable	permissible
jeep	jeep
syrap	syrup
precedessor	predecessor
coururier	couturier
plancenta	placenta
occassions	occasions
relitavely	relatively
plateu	plateau
undefined	undefined
country	country
streisand	streisand
proclaming	proclaiming
hypocrasy	hypocrisy
spoace	space
lbl	lbl
liuke	like
hydropobe	hydrophobe
evenhtually	eventually
yellow	yellow
devistating	devastating
defendent	defendant
commedic	comedic
noveau	nouveau
sandwhich	sandwich
theives	thieves
buring	burning
acadmic	academic
developement	development
becomeing	becoming
comparisions	comparisons
jheat	jheat
unacompanied	unaccompanied
nestin	nesting
veiques	vieques
cerimonies	ceremonies
flirt4	flirt 4
htikn	think
fbi	fbi
gunanine	guanine
philisopher	philosopher
naturely	naturally
correspondants	correspondents
dissapearance	disappearance
constipation	constipation
changable	changeable
incorprates	incorporates
intial	initial
agreing	agreeing
priciple	principle
hazmat	hazmat
unihabited	uninhabited
crash	crash
valdoxan	valdoxan
certificate	certificate
greif	grief
cemetaries	cemeteries
athenean	athenian
aircaft	aircraft
refridgerator	refrigerator
dispenced	dispensed
jokes	jokes
decison	decision
becomming	becoming
accomadations	accommodations
playright	playwright
labled	labelled
opression	oppression
hypoalbuminemia	hypoalbuminemia
medievel	medieval
senarios	scenarios
lonly	only
vacinity	vicinity
purposedly	purposely
forecast	forecast
archaeology	archaeology
comcast	comcast
pomotion	promotion
prolactin	prolactin
knoebels	knoebels
lisense	license
exept	except
weaponary	weaponry
europians	europeans
insitution	institution
lenscrafters	lenscrafters
calculator	calculator
nissan	nissan
d8s1179	d8s1179
tendacy	tendency
trackline	trackline
authorative	authoritative
upstander	upstander
boobs	boobs
acryllics	acrylics
rightbundlebranchblock	right bundle branch block
misdemenor	misdemeanor
agina	angina
predecesors	predecessors
cruise	cruise
htere	there
iminent	eminent
leathal	lethal
satric	satiric
definining	defining
substracts	subtracts
famoust	famous
occaison	occasion
premonasterians	premonstratensians
resticted	restricted
enviormentally	environmentally
sould	could
multipled	multiplied
counries	countries
autotronix	autotronix
particually	particularly
sgot	sgot
doens	does
aquiantance	acquaintance
fourty	forty
relient	reliant
dalmation	dalmatian
unsurprizing	unsurprising
megaman	mega man
wief	wife
aspire	aspire
manouvers	maneuvers
assoicate	associate
anbd	and
in2books	in2books
adherance	adherence
edd	edd
resteraunt	restaurant
cigna	cigna
vswiss	viswiss
pastural	pastoral
councellors	counselors
surounds	surrounds
costitution	constitution
occassionaly	occasionally
ruminant	ruminant
theather	theater
claerer	clearer
chemcial	chemical
poisin	poison
virutally	virtually
esitmated	estimated
thta	that
breaks	breaks
yeasr	years
consious	conscious
communites	communities
soilders	soldiers
cambrige	cambridge
succedded	succeeded
anthromorphization	anthropomorphization
legalforms	legal forms
asorbed	absorbed
caluculate	calculate
threee	three
cowlist	cowlist
bouyant	buoyant
internet	internet
agina	again
chatropolis	chatropolis
extravagent	extravagant
saveing	saving
fape	fape
specfic	specific
grwo	grow
triguered	triggered
rebiulding	rebuilding
katc	katc
remax	re max
hypocracy	hypocrisy
conotations	connotations
equialent	equivalent
phenomenonly	phenomenally
sage	sage
96815	96815
commongly	commonly
femtickler	femtickler
conjuction	conjunction
xnxx	xnxx
consectutive	consecutive
goitre	goitre
omim	omim
sideways	sideways
posess	possess
123	123
misdameanor	misdemeanor
helpfull	helpful
jaques	jacques
iarelative	iarelative
oridinarily	ordinarily
dowloads	downloads
mediciney	mediciny
assasins	assassins
imcomplete	incomplete
akebia	akebia
prominant	prominent
muscicians	musicians
presidental	presidential
virutal	virtual
refernces	references
fleas	fleas
knitting	knitting
interupt	interrupt
attemted	attempted
directory	directory
mariage	marriage
aledge	allege
prefered	preferred
dissobediance	disobedience
equilibium	equilibrium
definit	definite
unoticeable	unnoticeable
ufc	ufc
continous	continuous
masjid	masjid
stanton	stanton
corrisponding	corresponding
advertisments	advertisements
unilatreal	unilateral
terabyte	terabyte
klonopin	klonopin
oppinion	opinion
almsot	almost
manuever	maneuver
workststion	workstation
sa	sa
appologies	apologies
cellpading	cellpadding
hvea	have
child	child
profilic	prolific
skagerak	skagerrak
boots	boots
reknown	renown
nlm	nlm
enchancement	enhancement
baceause	because
longevinex	longevinex
hesistant	hesitant
coveralls	coveralls
dravadian	dravidian
feedmystarvingchildren	feed my starving children
unwarrented	unwarranted
emminent	eminent
prophacy	prophecy
ceratin	certain
mrinetwork	mrinetwork
tsunami	tsunami
strat	start
organiztion	organization
fetile	fertile
enviorment	environment
ftv	ftv
resistent	resistant
adminstrate	administrate
cassawory	cassowary
energy	energy
waiver	waiver
lookie	lookie
scoll	scroll
carribean	caribbean
extrordinarily	extraordinarily
twisty	twisty
confidental	confidential
parra	parra
clipdump	clipdump
stainlees	stainless
reffered	referred
radio	radio
govement	government
volounteering	volunteering
granny	granny
greenwich	greenwich
transfering	transferring
imense	immense
alltogether	altogether
doxie	doxie
membranaphone	membranophone
concensus	consensus
ayme	ayme
refusla	refusal
kwno	know
adressed	addressed
ghi	ghi
nabher	nabher
rediculous	ridiculous
succesfully	successfully
hyperthyroidism	hyperthyroidism
mailny	mainly
scrutinity	scrutiny
amatuer	amateur
procrastenation	procrastination
availablity	availability
seinor	senior
secratary	secretary
amplatzer	amplatzer
isocyanate	isocyanate
fynbos	fynbos
neigbourhood	neighbourhood
testiclular	testicular
reconcilation	reconciliation
priveledges	privileges
wresters	wrestlers
stemcellbill	stem cell bill
fafsa	fafsa
wamu	wamu
attension	attention
condamned	condemned
valetta	valletta
interfereing	interfering
spreaded	spread
wnats	wants
neuroscience	neuroscience
emprisoned	imprisoned
inseperable	inseparable
spred	spread
nmae	name
micoscopy	microscopy
daytona	daytona
studdy	study
entitity	entity
refromist	reformist
melena	melena
studebaker	studebaker
assitant	assistant
caracterized	characterized
inproving	improving
phillippines	philippines
gramatically	grammatically
onot	not
tetris	tetris
davita	davita
comets	comets
explotation	exploitation
provacative	provocative
surprize	surprise
wiht	with
pantomine	pantomime
warrriors	warriors
hostac	hostac
destablized	destabilized
repatition	repartition
housr	hours
pmi	pmi
phenomonon	phenomenon
paralel	parallel
inappropiate	inappropriate
fontrier	fontier
relected	reelected
clonidine	clonidine
jordan	jordan
esential	essential
communciation	communication
sofware	software
dael	deal
greenguy	greenguy
mathematican	mathematician
ammend	amend
medeival	medieval
coputer	computer
thalssemia	thalassemia
strenghtening	strengthening
pcbs	pcbs
superceeded	superseded
tradtionally	traditionally
dupaco	dupaco
eminated	emanated
influencial	influential
nowe	now
polyphonyic	polyphonic
resevoir	reservoir
seperate	separate
protoganist	protagonist
imediately	immediately
pffs	pffs
preample	preamble
collaberative	collaborative
wurst	wurst
humurous	humorous
kroq	kroq
bpao	bpao
comet	comet
orgin	origin
rudimentatry	rudimentary
har	har
nto	not
speciman	specimen
opthamologist	ophthalmologist
cheif	chief
gateaccess	gate access
athiesm	atheism
eventualy	eventually
gogin	gauguin
marryied	married
impatients	impatiens
catergorized	categorized
seing	seeing
beggining	beginning
promethazine	promethazine
shoudln	should
abondoned	abandoned
storeis	stories
parralel	parallel
unforetunately	unfortunately
omision	omission
cansa	cansa
yesterday	yesterday
architechtures	architectures
razadyne	razadyne
listners	listeners
misterious	mysterious
cartrige	cartridge
0	0
rf	rf
commiting	committing
elction	election
brandykill	brandy kill
cartilidge	cartilage
aggregious	egregious
vigeur	vigueur
ge	ge
bryologist	bryologist
ect	etc
noticeing	noticing
taht	that
commisioning	commissioning
belives	beliefs
ressurection	resurrection
puting	putting
ehealthinsurance	ehealthinsurance
labratory	laboratory
alegience	allegiance
painters	painters
yeild	yield
cartilege	cartilage
devasted	devastated
comision	commission
inherantly	inherently
markes	marks
maintainence	maintenance
bizzare	bizarre
fortelling	foretelling
wille	will
cannotation	connotation
gaspra	gaspra
befoer	before
personell	personnel
rivers	rivers
skateboarding	skateboarding
halifax	halifax
mountaingoat	mountain goat
genealogy	genealogy
recuiting	recruiting
healthfinder	healthfinder
not	not
transfered	transferred
hinderance	hindrance
attendence	attendance
hystoplasmosis	histoplasmosis
coform	conform
yeras	years
sophicated	sophisticated
conived	connived
archeaologist	archaeologist
arrangments	arrangements
italy	italy
accidentaly	accidentally
druming	drumming
coorperations	corporations
controvertial	controversial
behavour	behaviour
applicaiton	application
doulbe	double
hypotonia	hypotonia
optomism	optimism
shenandoah	shenandoah
performes	performs
cacuses	caucuses
lsdbe	lsdbe
adresing	addressing
allopone	allophone
anytying	anything
tghe	the
desinations	destinations
basile	basile
archimedian	archimedean
tjpanishad	upanishad
inteligence	intelligence
activly	actively
recuring	recurring
anulled	annulled
craiglist	craigslist
rememberable	memorable
practicioner	practitioner
ackward	awkward
birds	birds
tva	tva
populer	popular
diffrent	different
suspention	suspension
oraquick	oraquick
volonteers	volunteers
disagreeed	disagreed
annualcreditreport	annual credit report
exection	execution
scavanged	scavenged
constituional	constitutional
buring	during
potrayed	portrayed
pgande	pgande
appenines	apennines
examinated	examined
larceny	larceny
pertubation	perturbation
culvularia	curvularia
autoctonous	autochthonous
littel	little
morroco	morocco
verison	version
whith	with
percieved	perceived
undoubtely	undoubtedly
platycerium	platycerium
archos	archos
tuttle	tuttle
instatance	instance
switchboard	switchboard
maydepartmentstores	may department stores
bears	bears
civillian	civilian
prominantly	prominently
dissappointed	disappointed
inconsistant	inconsistent
religous	religious
entaglements	entanglements
steelwerksextremecom	steelwerks extreme com
predomiantly	predominately
acustom	accustom
medacine	medicine
galatic	galactic
honory	honorary
electon	electron
tihs	this
cardizim	cardizem
sunglases	sunglasses
todays	today s
makse	makes
mapquest	mapquest
whereever	wherever
perhpas	perhaps
siezures	seizures
responibilities	responsibilities
midwifes	midwives
upcomming	upcoming
foward	forward
oedi	oedi
meerkrat	meerkat
seceed	succeed
unchallengable	unchallengeable
r7u	r7u
eyar	eyas
wrbs	wrbs
occured	occurred
asthetic	aesthetic
doccumented	documented
unilatreally	unilaterally
presitgious	prestigious
oxylate	oxalate
mirrorred	mirrored
proceded	preceded
renewl	renewal
yeilding	yielding
alledged	alleged
excange	exchange
acheivement	achievement
58mvb	58mvb
contravercial	controversial
achive	archive
distruction	destruction
anomolous	anomalous
neigbour	neighbour
immitate	imitate
strenght	strength
toghether	together
sufficently	sufficiently
assasination	assassination
singsog	singsong
viburnum	viburnum
progessed	progressed
thsoe	those
creatine	creatine
konws	knows
98	98
braids	braids
proceedure	procedure
amerencips	amerencips
americandentalassociation	american dental association
commericial	commercial
unuseable	unusable
despiration	desperation
royalcaribbeaninternational	royal caribbean international
havaianas	havaianas
financial	financial
fiel	file
adecuate	adequate
peice	piece
lsat	last
wdok	wdok
hvae	have
circut	circuit
doub	doubt
incorportaed	incorporated
mamalian	mammalian
compatability	compatibility
defintion	definition
confortable	comfortable
finaly	finally
priviledge	privilege
suceeded	succeeded
trustworthyness	trustworthiness
equitorial	equatorial
msa	msa
porterville	porterville
asthma	asthma
foudn	found
trafic	traffic
emmisions	emissions
endig	ending
clarostat	clarostat
lerans	learns
tyrany	tyranny
corrisponds	corresponds
rockfish	rockfish
addtion	addition
ctv	ctv
interm	interim
ackward	backward
assocation	association
adipex	adipex
mispelled	misspelled
vagina	vagina
reenforced	reinforced
practicly	practically
whic	which
stubborness	stubbornness
suround	surround
colateral	collateral
particualr	particular
google	google
dificulty	difficulty
larzard	lazard
journey	journey
descisions	decisions
bureau	bureau
diapers	diapers
emnity	enmity
deteriate	deteriorate
encouraing	encouraging
embarras	embarrass
propperly	properly
novel	novel
acheiving	achieving
degarelix	degarelix
erested	erected
chemcially	chemically
sterotypes	stereotypes
unconfortability	discomfort
fianlly	finally
emperical	empirical
diea	idea
storise	stories
1120h	1120h
nuclear	nuclear
oging	going
likelyhood	likelihood
naturual	natural
truthinlending	truth in lending
webmdnews	webmd news
vestal	vestal
originnally	originally
alliviate	alleviate
neigbour	neighbor
trancending	transcending
progrom	program
affort	effort
volontary	voluntary
collegue	colleague
crowm	crown
captial	capital
ommision	omission
commemerative	commemorative
suburburban	suburban
satellite	satellite
eyam	eyam
unplesant	unpleasant
authobiographic	autobiographic
inctroduce	introduce
three	three
exibitions	exhibitions
noth	north
legomsky	legomsky
priveliges	privileges
phenonmena	phenomena
incompatablities	incompatibilities
ocurr	occur
higest	highest
reccuring	recurring
bergamont	bergamot
hieroglph	hieroglyph
digital	digital
dicovery	discovery
disctinction	distinction
faciliate	facilitate
sentinel	sentinel
orderlies	orderlies
symmetral	symmetric
excisted	existed
artillary	artillery
lep	lep
omiting	omitting
hierarcy	hierarchy
windshield	windshield
aquiring	acquiring
tolerence	tolerance
homogeneize	homogenize
spotsylvania	spotsylvania
nuecescounty	nueces county
wass	was
volounteer	volunteer
seras	seras
physicaly	physically
extremeophile	extremophile
colaborations	collaborations
humidor	humidor
oppossed	opposed
gucci	gucci
neigbours	neighbours
disemination	dissemination
godess	goddess
catholocism	catholicism
comander	commandeer
earnt	earned
fitzgeralds	fitzgeralds
jlab	jlab
golfsmith	golfsmith
funtion	function
briliant	brilliant
enxt	next
recieves	receives
oponent	opponent
accomplix	accomplix
hydroponic	hydroponic
taxanomy	taxonomy
autism	autism
weilded	wielded
polysaccharid	polysaccharide
loxitane	loxitane
compeitions	competitions
innoculated	inoculated
oposition	opposition
wohle	whole
analitic	analytic
strikely	strikingly
infallable	infallible
jazzersize	jazzercise
committments	commitments
muscician	musician
metalurgy	metallurgy
celadrin	celadrin
distingish	distinguish
notwhithstanding	notwithstanding
calander	calendar
colonizators	colonizers
huntingtonsdisease	huntington s disease
accquainted	acquainted
interrugum	interregnum
nineth	ninth
rosters	rosters
perversius	perversius
millenium	millennium
largst	largest
alowing	allowing
kggg	kggg
contruction	construction
keppra	keppra
anntaylorloft	ann taylor loft
aproximate	approximate
motivesb	motivesb
consequentually	consequently
decribing	describing
assit	assist
endevors	endeavors
busness	business
opose	oppose
epson	epson
avilable	available
casi	casi
diablical	diabolical
completelyl	completely
rebllions	rebellions
weather	weather
vermontcraiglist	vermont craigslist
ocasional	occasional
emmigrated	emigrated
chartermac	chartermac
prospecting	prospecting
embarrasment	embarrassment
recide	reside
consitutional	constitutional
atheneans	athenians
tenacle	tentacle
infrantryman	infantryman
ammendment	amendment
needtwat	needtwat
archtype	archetype
exagerates	exaggerates
intially	initially
irrelevent	irrelevant
regulaotrs	regulators
garments	garments
practially	practically
landforms	landforms
levetated	levitated
possiblities	possibilities
embarassing	embarrassing
importamt	important
ommitted	omitted
indipendent	independent
ealier	earlier
muncipality	municipality
murals	murals
grouse	grouse
clasic	classic
realitykings	reality kings
rewriet	rewrite
games	games
formelly	formerly
missen	mizzen
biden	biden
enviornmental	environmental
magasine	magazine
accoring	according
dispite	despite
gallaxies	galaxies
sciatica	sciatica
farkle	farkle
carmalite	carmelite
tsb	tsb
wantgaysex	want gay sex
inefficienty	inefficiently
unsed	unsaid
questlaboratories	quest laboratories
harras	harass
marrtyred	martyred
redbook	redbook
reccomend	recommend
terrestial	terrestrial
spriritual	spiritual
shihan	shihan
cxan	cyan
seperated	separated
unmistakeably	unmistakably
fiel	field
refrers	refers
realy	really
amaneusis	amanuensis
adres	address
thermohaline	thermohaline
northereastern	northeastern
tranform	transform
startegy	strategy
gastroparesis	gastroparesis
unmanouverable	unmaneuverable
albiet	albeit
music	music
excecutes	executes
sucesfully	successfully
clincial	clinical
competitiion	competition
nightime	nighttime
methaphor	metaphor
signifantly	significantly
dimond	diamond
honolulu	honolulu
foot	foot
selenium	selenium
establising	establishing
cosmology	cosmology
warsaw	warsaw
durig	during
fiels	feels
reicarnation	reincarnation
sportcam	sportcam
rigeur	rigueur
sicily	sicily
candadate	candidate
