parrallel	parallel
shoudln	should
millepede	millipede
consituency	constituency
cambrige	cambridge
clonidine	clonidine
esitmated	estimated
athenean	athenian
binoculars	binoculars
cartdridge	cartridge
jordan	jordan
authorative	authoritative
intial	initial
diapers	diapers
achive	achieve
referrence	reference
insitutions	institutions
watertown	watertown
similiarly	similarly
humurous	humorous
tonsilectomy	tonsillectomy
idiosyncracy	idiosyncrasy
konws	knows
accomodated	accommodated
pinapple	pineapple
commemerative	commemorative
lingerie	lingerie
durig	during
ctb	ctb
5150	5150
cleareance	clearance
spectaulars	spectaculars
earthquake	earthquake
ncsecu	ncsecu
listners	listeners
makse	makes
typicaly	typically
grittv	grittv
recivership	receivership
inheritage	inheritance
succedded	succeeded
condamned	condemned
extravagent	extravagant
paralel	parallel
committe	committee
formost	foremost
sytem	system
moeny	money
adderall	adderall
ehealthinsurance	ehealthinsurance
seperately	separately
disenchanged	disenchanted
aquiring	acquiring
unlocker	unlocker
excecutes	executes
initiaitive	initiative
gamaglobulin	gamma globulin
intered	interred
htink	think
costumes	costumes
rebiulding	rebuilding
anyhwere	anywhere
eventualy	eventually
chuch	church
mischievious	mischievous
whants	wants
abalone	abalone
hazmat	hazmat
plateu	plateau
attemts	attempts
aggresive	aggressive
sufferage	suffrage
russion	russian
honolulu	honolulu
amaneusis	amanuensis
offereings	offerings
dael	deal
citizen	citizen
meterologist	meteorologist
spotsylvania	spotsylvania
qutie	quite
portuguease	portuguese
excisted	existed
doctines	doctrines
markes	marks
roberts	roberts
accquainted	acquainted
subsquently	subsequently
arguements	arguments
lift	lift
marisota	marisota
catergorized	categorized
kabatogama	kabetogama
fatc	fact
gae	gael
caluclated	calculated
definetly	definitely
powerchevrolet	power chevrolet
infomation	information
alledges	alleges
coincedentally	coincidentally
desoriented	disoriented
porterville	porterville
caigslist	craigslist
profesion	profession
seinor	senior
efficent	efficient
oxylate	oxalate
consumated	consummated
ocurrence	occurrence
propmted	prompted
propperly	properly
peice	piece
pulmaney	pulmaney
accoring	according
synagouge	synagogue
protoganist	protagonist
illegimacy	illegitimacy
renewl	renewal
conotations	connotations
upgradded	upgraded
radify	ratify
ansalisation	nasalisation
snoqualmie	snoqualmie
albiet	albeit
amoung	among
immediatly	immediately
volounteers	volunteers
accomadations	accommodations
anntaylorloft	ann taylor loft
manouvers	maneuvers
inseperable	inseparable
bme	bme
itunes	itunes
wnats	wants
procrastenation	procrastination
monserrat	montserrat
commongly	commonly
whihc	which
aledge	allege
eraticly	erratically
selena	selena
exchanching	exchanging
churchs	churches
nineth	ninth
clarithromyc	clarithromycin
russina	russian
ecidious	deciduous
relevence	relevance
driectly	directly
teemaster	teemaster
gi5fvaxvl	gi5fvaxvl
ancestor	ancestor
unitesstates	unitedstates
shiped	shipped
theri	their
resistent	resistant
liftime	lifetime
phones	phones
transfering	transferring
noncombatents	noncombatants
coolmaths	cool maths
wiht	with
jstu	just
twisty	twisty
oppossed	opposed
refernces	references
foot	foot
undreground	underground
tabc	tabc
regalrailing	regal railing
voorhees	voorhees
dimentions	dimensions
entaglements	entanglements
harrassing	harassing
5up	5up
suppliementing	supplementing
equippment	equipment
existince	existence
storeis	stories
comissions	commissions
enlargments	enlargements
58mvb	58mvb
thast	that s
theilluminatingcompany	the illuminating company
designer	designer
gogin	going
drudgereport	drudge report
alchoholic	alcoholic
ackward	backward
refference	reference
questlaboratories	quest laboratories
scabe	scabe
oscillococcinum	oscillococcinum
palce	place
123	123
childbird	childbirth
scaleable	scalable
settlment	settlement
altho	although
beggins	begins
punding	punding
incorruptable	incorruptible
mailbox	mailbox
iminent	imminent
mailny	mainly
windshield	windshield
rediculous	ridiculous
mataphysical	metaphysical
faciliate	facilitate
sepina	subpoena
relized	realized
wildcats	wildcats
platycerium	platycerium
parkinsonism	parkinsonism
inadquate	inadequate
hydropile	hydrophile
contravercial	controversial
availaible	available
percieved	perceived
iceworms	ice worms
govormental	governmental
immediatley	immediately
thigmotropism	thigmotropism
abundancies	abundances
lerans	learns
perphas	perhaps
sponser	sponsor
constaints	constraints
bandwith	bandwidth
valdoxan	valdoxan
startegy	strategy
steelwerksextremecom	steelwerks extreme com
avastin	avastin
vigeur	vigor
greif	grief
archos	archos
unmanouverable	unmanoeuvrable
celadrin	celadrin
decribed	described
isnt	isn t
todya	today
satire	satire
sponzored	sponsored
hip	hip
morocco	morocco
adacel	adacel
finaly	finally
referiang	referring
archetecture	architecture
possition	position
playright	playwright
particularily	particularly
farenheit	fahrenheit
bpao	bpao
cellpading	cellpadding
torymidae	torymidae
seached	searched
presidental	presidential
gothenberg	gothenburg
dnrec	dnrec
fleas	fleas
jospeh	joseph
famoust	famous
preferrably	preferably
crystals	crystals
yelp	yelp
tzeltal	tzeltal
strictist	strictest
nos	nos
harrasing	harassing
primatively	primitively
verfication	verification
comminication	communication
hasbro	hasbro
electricly	electrically
religous	religious
healthfinder	healthfinder
guerrilas	guerrillas
ethose	those
breaks	breaks
architechtures	architectures
consolodate	consolidate
infallable	infallible
attendent	attendant
hostac	hostac
cato	cato
bouyant	buoyant
thna	than
higest	highest
occassionaly	occasionally
greentop	greentop
processer	processor
belligerant	belligerent
childen	children
conquerers	conquerors
immitating	imitating
hobos	hobos
haev	have
britian	britain
